a lot	багато	
able	здатний
about	про	
above	вище, над	
account	рахунок	
acid	кислота	
across	через
active	активний	
activity	діяльність	
afraid	наляканий	
after	після	
again	знову	
against	проти	
age	вік	
ago	 тому	
air	повітря	
all	все	
almost	майже	
alone	сам
along	вздовж
already	вже	
always	завжди	
among	серед	
amount	кількість	
and		і	
angry	сердитий	
animal	тварина	
another	інший, ще один	
answer	відповідь	
ant	мураха	
any	будь-який	
anyone	хто-небудь	
anything	будь-що	
anytime	в будь-який час	
apple	яблуко	
area	площа, ділянка	
arm	рука	
army	армія	
around	навколо	
art	мистецтво	
as	як	
at	на
attention	увага	
aunt	тітка	
autumn	осінь	
away	далеко, геть	
baby	дитина	
back	назад	
bad	поганий	
bag	мішок	
ball	м'яч	
band	гурт, група	
bank	банк	
base	база	
basket	кошик	
bath	ванна	
bean	квасоля	
bear	ведмідь	
beautiful	красивий	
because	тому що	
bed	ліжко	
bedroom	спальня	
bee	бджола	
beer	пиво	
before	 перед	
behind	позаду	
bell	дзвін	
below	нижче	
berry	ягода	
besides	крім	
best	найкращий	
better	краще	
between	між	
big	великий	
bird	птах	
birth	народження	
birthday	день народження	
bit	шматок	
bitter	гіркий	
black	чорний	
blade	лезо	
block	блок	
blood	кров	
blue	синій	
board	дошка	
boat	човен	
body	тіло	
bone	кістка	
book	книга	
boot	чобіт	
border	межа	
born	народжений	
both	обидва	
bottle	пляшка	
bottom	дно	
bowl	чаша	
box	коробка	
boy	хлопець	
brain	мозок	
branch	гілка	
brave	хоробрий	
bread	хліб	
breakfast	сніданок	
brick	цеглина	
bridge	міст	
bright	яскравий	
brother	брат	
brown	коричневий	
brush	щітка	
bucket	відро	
bus	автобус	
business	бізнес	
busy	зайнятий	
but	але	
butter	масло	
button	ґудзик	
cake	торт	
camera	фотоапарат	
can	могти	
candle	свічка	
cap	кришка	
car	автомобіль	
card	карта	
careful	обережним	
careless	безтурботний	
case	справа	
cat	кіт	
central	центральний	
century	століття	
certain	певний	
chain	ланцюг	
chair	стілець	
chalk	крейда	
chance	шанс	
cheap	дешевий	
cheese	сир	
chest	груди	
chicken	курка	
child	дитина	
children	діти	
chin	підборіддя	
chocolate	шоколад	
choice	вибір	
church	церква	
circle	коло	
city	місто	
class	клас	
clean	чистий	
clear	ясно	
clever	розумний	
clock	годинник	
close	близько	
cloth	тканина	
clothes	одяг	
cloud	хмара	
cloudy	хмарний	
coal	вугілля	
coat	пальто	
coffee	кава	
coin	монета	
cold	холодний	
collar	комір	
colour	колір	
comb	гребінь	
comfortable	зручний	
common	загальний	
company	компанія	
complete	повний, завершений	
complex	складний	
computer	комп'ютер	
condition	стан	
cool	прохолодно	
copper	мідь	
cord	шнур	
corn	кукурудза	
corner	кут	
correct	правильний	
cotton	бавовна, вата	
cough	кашель	
country	країна	
course	курс	
cow	корова	
crack	тріщина	
crash	аварія	
crime	злочин	
cruel	жорстокий	
cup	чашка	
cupboard	шафа	
curtain	штора	
curve	вигин	
cushion	диванна подушка	
damage	пошкодження	
dance	танець	
danger	небезпека	
dangerous	небезпечний	
dark	темний	
daughter	дочка	
day	день	
dead	мертвий	
dear	любий	
death	смерть	
debt	борг	
decision	рішення	
deep	глибокий	
deer	олень	
degree	ступінь	
delicate	тонкий, делікатний	
dependent	залежний	
design	дизайн	
desire	бажання	
desk	стіл	
destruction	знищення	
detail	деталь	
development	розвиток	
different	інший	
difficult	складний	
digestion	травлення	
dinner	вечеря	
direction	напрямок	
dirty	брудний	
discovery	відкриття	
discussion	дискусія	
disease	хвороба	
disgust	огида	
dish	блюдо	
distance	відстань	
distribution	розподіл	
dog	собака	
door	двері	
double	подвійний	
doubt	сумнів	
down	вниз	
drain	водостік	
drawer	шухляда	
dream	мрія	
dress	плаття	
drop	крапля	
dry	сухий	
duck	качка	
dust	пил	
duty	обов'язок	
each	кожен	
ear	вухо	
early	рано	
earth	земля	
east	схід	
easy	легко	
edge	край	
education	освіта	
effect	ефект	
egg	яйце	
eight	вісім	
either	або	
electric	електричний	
elephant	слон	
else	ще	
empty	порожній	
end	кінець	
enemy	ворог	
engine	двигун	
enough	достатньо	
entrance	вхід	
equal	рівний	
error	помилка	
escape	втеча	
even	навіть	
evening	вечір	
event	подія	
ever	коли-небудь	
every	кожен	
everybody	всі	
everyone	всі	
exact	точний	
examination	експертиза	
example	приклад	
except	крім	
excited	 схвильований	
exercise	вправа	
expensive	дорогий	
experience	досвідпі	
extremely	 надзвичайно	
eye	очей	
face	лице	
fact	факт	
fail	провал	
false	помилковий	
family	сім'я	
famous	відомий	
far	далеко	
farm	ферма	
fast	швидкий	
fat	жир, товстий	
father	батько	
fault	вина	
fear	страх	
feather	пір'я	
female	жінка	
fever	лихоманка	
few	кілька	
field	поле	
fight	боротьба	
film	фільм	
fine	добрий
finger	палець	
fire	вогонь	
first	перший	
fish	риба	
five	п'ять	
flag	прапор	
flame	полум'я	
flat	плоский	
flight	політ	
floor	підлога
flour	борошно	
flower	квітка	
food	їжа	
fool	дурень	
foot	стопа	
football	футбол	
for	для	
force	сила	
foreign	іноземний	
forest	ліс	
fork	виделка	
form	форма	
forward	вперед	
four	чотири	
fox	лисиця	
frame	рамка	
free	вільний	
freedom	свобода	
fresh	свіжий	
friend	друг	
friendly	доброзичливий	
from	від	
front	передній	
fruit	фрукт	
full	повний	
fun	веселощі	
funny	смішний	
furniture	меблі	
further	далі	
future	майбутнє	
game	гра	
garden	сад	
gate	ворота	
general	загальний	
gentleman	джентльмен	
gift	подарунок	
girl	дівчина	
glad	радий	
glass	скло	
glove	рукавиця	
goat	коза	
god	бог	
gold	золото	
good	добрий
goodbye	до побачення	
government	уряд	
grain	зерно	
grandfather	дід	
grandmother	бабуся	
grass	трава	
grave	могила	
great	великий	
green	зелений	
grey	сірий	
ground	земля	
group	група	
growth	ріст	
gun	пістолет	
hair	волосся	
half	половина	
hall	зал	
hammer	молоток	
hand	рука	
happy	щасливий	
hard	жорсткий	
hat	капелюх	
he	він	
head	голова	
healthy	здоровий	
heart	серце	
heat	спека, тепло	
heaven	небо	
heavy	важкий	
height	висота	
hello	привіт	
hen	курка	
her	її	
here	тут	
hers	її	
high	високий	
hill	пагорб	
him	його(йому)	
his	його	
history	історія	
hobby	хобі	
hole	отвір	
holiday	свято	
home	дім	
hook	гак	
hope	надія	
horn	ріг	
horse	кінь	
hospital	лікарня	
hot	гарячий	
hotel	готель	
hour	година	
house	будинок	
how	як	
humor	гумор	
hundred	сто	
hungry	голодний	
husband	чоловік	
I	я	
ice	лід	
idea	ідея	
if	якщо	
ill	хворий	
important	важливий	
in	в	
industry	промисловість	
ink	чорнило	
insect	комаха	
inside	всередині	
interesting	цікавий	
into	в	
iron	залізо	
island	острів	
it	 це	
its	його	
jelly	желе	
jewel	коштовність	
job	робота	
joke	жарт	
journey	подорож	
judge	суддя	
juice	сік	
just	тільки	
key	ключ		
kind	вид	
king	король	
kiss	поцілунок	
kitchen	кухня	
knee	коліно	
knife	ніж	
knot	вузол	
knowledge	знання	
ladder	драбина	
lady	леді	
lamp	лампа	
land	земля	
language	мова	
large	великий	
last	останній	
late	пізно	
lately	останнім часом	
law	закон	
lazy	ледачий	
leaf	листок	
leather	шкіра	
left	лівий	
leg	нога	
length	довжина	
less	менше	
lesson	урок	
letter	 буква	
level	рівень	
library	бібліотека	
lie	брехня	
life	життя	
light	світло	
line	лінія	
lion	лев	
lip	губа	
list	список	
little	малий	
lock	замок	
lonely	одинокий	
long	довгий	
loud	голосний	
love	любов	
low	низький	
lower	нижче	
luck	удача	
machine	машина	
main	головний	
male	чоловік
man	чоловік, людина	
many	багато	
map	карта	
mark	знак	
market	ринок	
may	могти	
me	мені(мене)	
meal	їжа	
meat	м'ясо	
medicine	ліки	
member	член	
memory	пам'ять	
method	метод	
middle	середина	
milk	молоко	
million	мільйон	
mind	розум	
minute	хвилина	
mistake	помилка	
model	модель	
modern	сучасний	
moment	момент	
money	гроші	
monkey	мавпа	
month	місяць 
moon	місяць	
more	більше	
morning	ранок	
most	найбільш	
mother	мама	
mountain	гора	
mouth	рот	
much	багато	
muscle	м'яз	
music	музика	
must	повинен	
my	мій	
nail	ніготь	
name	ім'я	
narrow	вузький	
nation	народ	
nature	природа	
near	поряд	
nearly	майже	
necessary	необхідно	
neck	шия	
needle	голка	
neighbour	сусід	
neither ні
nor	ні	
net	сітка	
never	ніколи	
new	новий	
news	новини	
newspaper	газета	
next	наступний	
nice	хороший	
night	ніч	
nine	дев'ять	
no	ні	
noble	благородний	
noise	шум	
none	жоден	
north	північ	
nose	ніс	
not	не	
nothing	ніщо	
now	зараз	
number	номер	
nut	горіх	
object	об'єкт	
ocean	океан	
offer	пропозиція	
office	офіс	
often	часто	
oil	олія	
old	старий	
on	на	
one	один	
only	тільки	
opinion	думка	
opposite	протилежний	
or	або	
orange	оранжевий	
order	порядок	
other	інший	
our	наш	
out	з	
outside	назовні	
oven	духовка	
over	над	
own	власний	
owner	власник	
page	сторінка	
pain	біль	
paint	фарба	
pair	пара	
pan	сковорідка	
paper	папір		
park	парк	
part	частина	
partner	партнер	
party	вечірка	
past	минуле	
path	шлях, стежка	
peace	мир	
pen	ручка	
pencil	олівець	
people	люди	
pepper	перець	
perfect	ідеальний	
period	період	
person	людина	
petrol	бензин	
photograph	фотографія	
piano	піаніно	
picture	картина	
piece	шматок	
pig	свиня	
pin	шпилька	
pink	рожевий	
pipe	труба	
place	місце	
plane	літак	
plant	рослина	
plastic	пластик	
plate	тарілка	
please	будь ласка	
pleased	задоволений	
plenty	багато	
pocket	кишеня	
point	точка	
poison	отрута	
police	поліція	
polite	ввічливий	
pool	басейн	
poor	бідний	
popular	популярний	
position	місце
possible	можливий	
pot	горщик	
potato	картопля	
powder	порошок
power	сила	
present	теперішній	
pretty	гарний	
price	ціна	
prince	принц	
prison	в'язниця	
private	приватний	
prize	приз	
probably	ймовірно	
problem	проблема	
process	процес	
profit	прибуток	
proper	правильний	
public	суспільний	
punishment	покарання	
pupil	учень	
purpose	мета, намір	
quality	якість	
queen	королева	
question	питання	
quick	швидкий	
quiet	тихий	
quite	досить	
radio	радіо	
railroad	залізниця	
rain	дощ	
rainy	дощовий	
rat	пацюк	
ray	промінь	
ready	готовий	
real	реальний	
really	дійсно	
reason	причина	
record	запис	
red	червоний	
rent	оренда	
report	звіт	
request	запит
respect	повага	
responsible	відповідальний	
restaurant	ресторан	
result	результат	
reward	нагорода	
rice	рис	
rich	багатий	
right	правий	
ring	кільце	
river	річка	
road	дорога	
rock	камінь	
roof	дах	
room	кімната	
root	корінь	
rough	грубий	
round	круглий	
rubber	гума	
rude	грубий	
rule	правило	
ruler	правитель	
sad	сумний	
safe	безпечний	
salt	сіль	
same	той самий	
sand	пісок	
school	школа	
science	наука	
scissors	ножиці	
sea	море	
seat	сидіння	
second	другий	
secret	таємниця	
seed	насіння	
self	сам	
sentence	речення	
serious	серйозний	
seven	сім	
several	кілька	
shade	відтінок	
shadow	тінь	
shame	сором
shape	форма	
sharp	гострий	
she	вона	
sheep	вівця	
sheet	лист
shelf	полиця	
ship	корабель	
shirt	сорочка	
shoe	взуття	
shop	магазин	
short	короткий	
should	повинен	
shoulder	плече	
sick	хворий	
side	сторона	
sign	знак	
signal	сигнал	
silence	тиша	
silk	шовк	
silly	дурний	
silver	срібло	
similar	схожий	
simple	простий	
since	з	
single	один	
sink	раковина	
sister	сестра	
six	шість	
size	розмір	
skill	вміння	
skin	шкіра	
skirt	спідниця	
sky	небо	
slope	схил	
slow	повільний	
small	невеликий	
smell	запах	
smile	посмішка	
smoke	дим	
smooth	рівний	
snake	змія	
snow	сніг	
so	так	
soap	мило	
society	суспільство	
sock	шкарпетка	
soft	м'який	
solid	твердий	
some	деякий	
someone	хтось	
something	щось	
sometimes	іноді	
son	син	
song	пісня	
soon	скоро	
sorry	вибачте	
sound	звук	
soup	суп	
south	південь	
space	простір	
special	спеціальний	
speed	швидкість	
sponge	губка	
spoon	ложка	
sport	спорт	
spring	весна	
square	квадрат	
stage	етап	
stamp	штамп	
star	зірка	
start	початок	
station	станція	
steam	пар	
step	крок	
stick	палиця	
sticky	липкий	
still	 досі	
stitch	 шов	
stomach	шлунок	
stone	камінь	
stop	стоп	
store	магазин	
storm	буря	
story	історія
straight	прямий	
strange	дивний	
street	вулиця	
strong	сильний	
structure	структура	
student	студент	
stupid	дурний	
subject	тема	
substance	речовина	
successful	успішний	
such	такий	
suddenly	раптом	
sugar	цукор	
suitable	відповідний	
summer	літо	
sun	сонце	
sunny	сонячний	
support	підтримка	
sure	звичайно
surprise	сюрприз	
sweet	солодкий	
sword	меч	
system	система	
table	стіл	
tail	хвіст	
tall	високий	
taste	смак	
tax	податок	
taxi	таксі	
tea	чай	
team	команда	
tear	сльоза	
telephone	телефон	
television	телебачення	
ten	десять	
tennis	теніс	
terrible	жахливий	
test	тест	
than	ніж	
that	той	
the		  
an	   
their	їх	
then	потім	
there	там	
therefore	тому	
these	ці	
thick	товстий	
thin	тонкий	
thing	річ	
third	третій	
this	це	
though	хоча	
threat	загроза	
three	три	
throat	горло	
through	через	
thumb	палець
thunder	грім	
ticket	квиток	
tidy	акуратний	
tight	щільний	
time	час	
tin	олово	
tired	втомлений	
title	назва	
act	діяти	
add	додавати	
agree	погоджуватися	
appear	з'являтися	
arrive	приїхати	
ask	запитати	
attack	атакувати	
be	бути	
begin	почати	
behave	поводитися	
bite	вкусити	
bleed	кровоточити	
blow	дути	
boil	кип'ятити	
borrow	зичити	
break	ламати	
breathe	дихати	
bring	приносити	
build	будувати	
burn	спалювати	
buy	купити	
call	кликати	
care	доглядати	
carry	нести	
catch	ловити	
change	змінювати	
chase	гнатися	
choose	вибирати	
climb	залазити	
collect	збирати	
come	приходити	
compare	порівняти	
contain	містити	
continue	продовжувати	
control	контролювати	
cook	куховарити	
cost	коштувати	
count	рахувати	
cover	накривати	
cross	перетинати	
cry	кричати
cut	різати	
decide	вирішити	
decrease	зменшити	
depend	залежати	
destroy	знищити	
develop	розвивати	
die		померти	
discover	відкрити	
do	робити	
draw	малювати	
drink	пити	
drive	водити	
earn	заробляти	
eat	їсти	
enjoy	насолоджуватися	
enter	заходити	
expect	очікувати	
explain	пояснювати	
fall	падати	
feed	годувати	
feel	відчувати	
fill	заповнити	
find	знаходити	
finish	завершувати	
fit	відповідати
fix	виправити	
float	плавати	
fly	літати	
fold	складати	
forget	забувати	
forgive	пробачати	
freeze	заморожувати	
get	отримати	
give	дати	
go	йти	
grow	рости	
happen	відбуватися	
hate	ненавидіти	
have	мати	
hear	чути	
help	допомагати	
hide	ховати	
hit	вдарити	
hold	тримати	
hurry	поспішати	
hurt	травмувати	
increase	збільшувати	
introduce	представляти	
invent	винаходити	
invite	запрошувати	
join	приєднатися	
jump	стрибати	
keep	тримати	
kill	вбити	
knock	стукати	
know	знати	
laugh	сміятися	
lead	вести	
learn	вчитися	
leave	залишати	
lend	зичити	
let	дозволяти	
like	любити	
listen	слухати	
live	жити	
look	дивитися	
lose	втратити	
make	робити	
marry	одружитися	
matter	мати значення	
mean	означати	
measure	вимірювати	
meet	зустрічати	
mention	згадати	
miss	пропускати	
mix	змішувати	
move	рухатися	
need	потребувати	
notice	помічати	
obey	підкорятися	
open	відкривати	
pass	проходити	
pay	платити	
pick	вибирати	
play	грати	
pour	лити	
press	натиснути	
prevent	запобігати	
produce	виробляти	
promise	обіцяти	
protect	захищати	
provide	надати	
pull	тягнути	
punish	покарати	
push	штовхати	
put	покласти	
raise	піднімати	
reach	досягати	
read	читати	
receive	отримати	
remember	пам'ятати	
remind	нагадувати	
remove	видаляти	
repair	ремонтувати	
repeat	повторювати	
reply	відповісти	
rest	відпочивати	
return	повертатися	
ride	їхати	
rise	зростати	
rob	грабувати	
run	бігати	
rush		поспішати	
sail		плавати
save		зберігати
say		сказати	
search	шукати	
see		бачити	
seem		здаватися	
sell		продавати	
send		послати	
serve	служити	
shake	трясти	
share	ділитися	
shine	блистіти	
shoot	стріляти	
shout	кричати	
show		показувати	
sing		співати	
sit		сидіти	
sleep	спати	
slip		ковзати	
speak	говорити	
spell	вимовляти	
spend	витрачати	
spread	поширювати	
stand	стояти	
stay		залишатися	
steal	красти	
study	вчитися	
swim		плавати	
take		брати	
talk		розмовляти	
teach	вчити	
tell		казати	
think	думати	
tie		зв'язувати	
touch	торкнутися	
travel	подорожувати	
try		намагатися	
understand		розуміти	
use		використовувати	
visit	відвідувати	
wait		чекати	
wake		розбудити	
walk		ходити	
want		хотіти	
wash		мити	
watch	дивитися	
wear		носити	
win		перемагати	
wonder	дивуватися	
worry	турбуватися	
write	писати	
today	сьогодні	
toe		палець на нозі	
together	разом	
tomorrow	завтра	
tongue		язик	
tonight		сьогодні ввечері	
too		занадто	
tool	інструмент	
tooth	зуб	
top		 верхній	
total	 весь	
town	місто	
train	поїзд	
tram	трамвай	
tree	дерево	
trouble		біда	
trousers	штани	
true	 правдивий	
trust	довіра	
turn	поворот	
twice	двічі	
type	тип	
umbrella	парасоля	
uncle	дядько	
under	під	
unit	розділ, частина	
until	до, доки	
up	вгору	
useful	корисний	
usual	звичайний	
usually		зазвичай	
value	цінність
vegetable	овоч	
very	дуже	
view	вид, погляд	
village		село	
violent		жорстокий	
voice	голос	
wall	стіна	
warm	теплий	
waste	відходи	
water	вода	
wave	хвиля	
wax		віск	
way		шлях	
we		ми	
weak	слабкий	
weather		погода	
wedding		весілля	
week	тиждень	
weight		вага	
welcome		ласкаво просимо	
well	добре	
west	захід	
wet		мокрий	
what	що	
wheel	колесо	
when	коли	
where	де	
which	 котрий	
while	в той час як	
whistle		свисток	
white	білий	
who		хто	
why		чому	
wide	широкий	
wife	дружина	
wild	дикий	
will	воля	
wind	вітер	
window		вікно	
wine	вино	
wing		крило	
winter		зима	
wire		дріт	
wise		мудрий	
wish		бажання	
with		з	
without		без	
woman		жінка	
wood	дерево	
wool	шерсть	
word	слово	
work		робота	
world		світ	
worm		хробак	
worst		найгірший	
wound		рана	
wrong		неправильно	
year		рік	
yellow		жовтий	
yes	 так	
yesterday	вчора	
yet 	ще	
you	   ти	
young	молодий	
your	твій	
zero	нуль	
zoo 	зоопарк
I	я
he	він
she	вона
we	ми
us	нас
they	вони
hit	вдарити
don't	не
wont	хотіти
i	я
to 		  
a	